####B#####
# ## ##  #
#  # ### #
## # ##  #
##   #  ##
### #  ###
###   ####
#### #####
####A#####
##########
